@@@@@@@@@@@@@@@@@@@@
@S@@@@@@@@@@@@@@   @
@ @@   @@@@@   @ @ @
@ @@ @ @@@   @ @ @ @
@ @@ @     @@@ @ @ @
@    @ @@@ @ @ @ @ @
@ @@@@@@ @ @ @ @ @ @
@ @      @ @ @   @ @
@ @ @@@@@@ @ @@@@@ @
@ @ @      @       @
@ @ @ @@@@   @@@@@@@
@ @   @  @ @@@     @
@ @@@@@ @@ @   @@@ @
@       @@   @@@ @ @
@@@@@@@ @@ @@@     @
@       @@ @ @ @@@@@
@ @@@@@@@  @       @
@ @@@@@@@@@@@@@@@@ @
@                @E@
@@@@@@@@@@@@@@@@@@@@
