@@@@@@@@@@@@@@@@@@@@@@@@@@@@@@@@@@@@@@@@
@S                  @                  @
@ @@@@@@@@ @@@@@@@@@@@@@@@@@@@@@@@@@@@ @
@ @                 @                  @
@ @ @@@@@@ @@@@@@@@   @@@@@@@@@@@@@@@@@@
@ @                 @                  @
@ @@@@@@@@ @@@@@@@@@@@@@@@@@@@@@@@@@@@ @
@ @                 @                  @
@ @ @@@@@@ @@@@@@@@@@@@@@@@@@@@@@@@@@@@@
@ @                 @                  @
@ @@@@@@@@ @@@@@@@@@@@@@@@@@@@@@@@@@@@ @
@ @                 @                  @
@ @ @@@@@@ @@@@@@@@   @@@@@@@@@@@@@@@@@@
@ @                 @                  @
@ @@@@@@@@ @@@@@@@@@@@@@@@@@@@@@@@@@@@ @
@ @                 @                  @
@ @ @@@@@@ @@@@@@@@   @@@@@@@@@@@@@@@@@@
@ @                 @                  @
@ @@@@@@@@ @@@@@@@@@@@@@@@@@@@@@@@@@@@ @
@ @                 @                  @
@ @ @@@@@@ @@@@@@@@@@@@@@@@@@@@@@@@@@@@@
@ @                 @                  @
@ @@@@@@@@ @@@@@@@@   @@@@@@@@@@@@@@@@ @
@ @                 @                  @
@ @ @@@@@@ @@@@@@@@@@@@@@@@@@@@@@@@@@@@@
@ @                 @                  @
@ @@@@@@@@ @@@@@@@@@@@@@@@@@@@@@@@@@@@ @
@ @                 @                  @
@ @ @@@@@@ @@@@@@@@   @@@@@@@@@@@@@@@@@@
@ @                 @                  @
@ @@@@@@@@ @@@@@@@@@@@@@@@@@@@@@@@@@@@ @
@ @                 @                  @
@ @ @@@@@@ @@@@@@@@   @@@@@@@@@@@@@@@@@@
@ @                 @                  @
@ @@@@@@@@ @@@@@@@@@@@@@@@@@@@@@@@@@@@ @
@ @                                  @ @
@ @ @@@@@@@@@@@@@@@@@@@@@@@@@@@@@@@@@@ @
@ @@@@@@@@@@@@@@@@@@@@@@@@@@@@@@@@@@@@ @
@                                    @E@
@@@@@@@@@@@@@@@@@@@@@@@@@@@@@@@@@@@@@@@@
