@@@@@@@@@@@@@@@@@@@@
@   @ @     @      @
@ @@@ @@@ @   @@@@ @
@         @ @@@  @ @
@ @@@ @@@ @ @  @ @ @
@ @ @ @ @ @ @ @@ @ @
@ @ @ @ @ @ @      @
@   @ @   @ @ @@@@ @
@@@@@ @@@@@@@ @  @ @
@        S@E@ @@ @ @
@ @@@@@@@@@ @@@@ @ @
@ @       @ @@ @ @ @
@ @ @@@@  @ @@ @ @ @
@ @  @@   @ @@ @ @ @
@ @ @@  @ @ @@ @ @ @
@ @@@  @@ @ @@ @ @ @
@ @@  @   @    @ @ @
@ @  @@ @@@ @@@@ @ @
@   @@    @        @
@@@@@@@@@@@@@@@@@@@@
