@@@@@@@@@@@@@@@@@@@@
@S                 @
@ @@@@@@@@@@@@@@@@ @
@ @                @
@ @ @@@@@@@@@@@@@@@@
@ @                @
@ @@@@@@@@@@@@@@@@ @
@ @                @
@ @ @@@@@@@@@@@@@@@@
@ @                @
@ @@@@@@@@@@@@@@@@ @
@ @                @
@ @ @@@@@@@@@@@@@@@@
@ @                @
@ @@@@@@@@@@@@@@@@ @
@ @@@@@@@@@@@@@@@@ @
@ @@@@@@@@@@@@@@@@ @
@ @@@@@@@@@@@@@@@@ @
@                 E@
@@@@@@@@@@@@@@@@@@@@
